#domain
hospital
#levelname
MAExample
#colors
red: 0, A
green: 1, B
#initial
+++++++++++++++++++++++++
+          ++++++++++++++
+          ++++++++++++++
+      1   0   B A      +
+          ++++++++++++++
+          ++++++++++++++
+++++++++++++++++++++++++
#goal
+++++++++++++++++++++++++
+    0     ++++++++++++++
+          ++++++++++++++
+                      A+
+          ++++++++++++++
+     1    ++++++++++++++
+++++++++++++++++++++++++
#end
