#domain
hospital
#levelname
MAExample
#colors
red: 0, A
green: 1, B
blue: C
purple: 2, D
orange: 3, E
pink: 4, 5, F
#initial
+++++++++++++++++++++++++
+ F D3     +C++5+++++++++
+ F D      ++++++++++++++
+EEED  1   0   B A      +
+ 4 D      ++++++++++++++
+   D      +2++++++++++++
+++++++++++++++++++++++++
#goal
+++++++++++++++++++++++++
+ F D     0+C++5+++++++++
+ F D      ++++++++++++++
+EEED                  A+
+   D      ++++++++++++++
+   D     1+ ++++++++++++
+++++++++++++++++++++++++
#end
