#domain
hospital
#levelname
MAKarlMarx
#colors
blue: 0, A, B, C, D, E, F, G, H, I, J, K
#initial
+++++++++++++++++++++++++
++ + + + + +  + + + + + +
+0KJIHGFEDCBAKJIHGFEDCBA+
++ + + + + ++ + + + + +++
+++++++++++++++++++++++++
#goal
+++++++++++++++++++++++++
++A+C+E+G+I+KA+C+E+G+I+K+
+                       +
++B+D+F+H+J++B+D+F+H+J+++
+++++++++++++++++++++++++
#end
