#domain
hospital
#levelname
SomeConflictMulti
#colors
red: 0, A
green: 1, B
blue: 2,3, C
#initial
++++++++++++++
+       0 2  +
+A           +
+            +
+            +
+            +
+          3 +
+ 1          +
+       B    +
+            +
+  C         +
+           C+
++++++++++++++
#goal
++++++++++++++
+            +
+B           +
+            +
+            +
+A           +
+            +
+            +
+            +
+            +
+            +
+  C     C   +
++++++++++++++
#end
