#domain
hospital
#levelname
MAExample
#colors
red: 0, A
green: 1, B
blue: 2, C
#initial
++++++++++++++
+       0+2  +
+A       +   +
+        +   +
+        +   +
+        +   +
++++++++++   +
+ 1      +   +
+       B+   +
+        +   +
+        +   +
+        +C  +
++++++++++++++
#goal
++++++++++++++
+        +   +
+        +   +
+        +   +
+        +   +
+A       +   +
++++++++++   +
+        +   +
+        +   +
+        +   +
+        +   +
+       B+  C+
++++++++++++++
#end
