#domain
hospital
#levelname
MAExample
#colors
red: 0, A
green: 1, B
blue: 2, C
#initial
++++++++++++++
+       0+   +
+A       +   +
+        +   +
+        +   +
+        +   +
++++++++++   +
+ 1      +   +
+       B+   +
+        +   +
+        +   +
+        +   +
++++++++++++++
#goal
++++++++++++++
+        +   +
+        +   +
+        +   +
+        +   +
+A       +   +
++++++++++   +
+        +   +
+        +   +
+        +   +
+        +   +
+       B+   +
++++++++++++++
#end
