#domain
hospital
#levelname
MAExample
#colors
red: 0,1,A,B,C
#initial
++++++++++++++
+       0+   +
+A       +   +
+        +   +
+        +   +
+       C+   +
++++++++++   +
+ 1      +   +
+       B+   +
+        +   +
+        +   +
+        +   +
++++++++++++++
#goal
++++++++++++++
+        +   +
+        +   +
+        +   +
+        +   +
+A   C   +   +
++++++++++   +
+        +   +
+        +   +
+        +   +
+        +   +
+       B+   +
++++++++++++++
#end
