#domain
hospital
#levelname
SAD3
#colors
red: A, 0, A, A, A
#initial
+++++++++++++++++++
+ A               +
+           0  ++++
+    A            +
+              ++A+
+        A      + +
+++++++++++++++++++
#goal
+++++++++++++++++++
+                 +
+              ++++
+                 +
+              ++ +
+               +A+
+++++++++++++++++++
#end
