#domain
hospital
#levelname
SAsimple3
#colors
red: 0, A, B
#initial
++++++++++++
+       0+ +
+ ++++++++A+
+          +
+ ++++++++ +
+B+        +
++++++++++++
#goal
++++++++++++
+        +A+
+ ++++++++ +
+          +
+ ++++++++ +
+ +B       +
++++++++++++
#end
