#domain
hospital
#levelname
SAsoko3_08
#colors
red: 0, A
#initial
++++++++++
+0A      +
+ A      +
+ A      +
+ A      +
+ A      +
+ A      +
+ A      +
+ A      +
++++++++++
#goal
++++++++++
+       A+
+       A+
+       A+
+       A+
+       A+
+       A+
+       A+
+       A+
++++++++++
#end
