#domain
hospital
#levelname
MAKJFWAOL
#colors
red: 0,A
blue:1,B
green:2,C
#initial
+++++++++++
+   1+A   +
+    +    +
+         +
+    +    +
+    +    +
+    +    +
+   C+2   +
+    +    +
+    +    +
+         +
+    +    +
+    +    +
+    +    +
+   B+0   +
+++++++++++
#goal
+++++++++++
+    + A  +
+    +    +
+C        +
+    +    +
+    +    +
+    +    +
+    +    +
+    +    +
+    +    +
+         +
+    +    +
+    +    +
+    +    +
+  B +    +
+++++++++++
#end
