#domain
hospital
#levelname
MANikrima
#colors
red: 0,C,A
green: 1,B
#initial
++++++++++++
+       0+ +
+ +C++++++A+
+          +
+B++++++++ +
+ +1       +
++++++++++++
#goal
++++++++++++
+        +A+
+ + ++++++ +
+ C        +
+ ++++++++ +
+B+        +
++++++++++++
#end
