#domain
hospital
#levelname
SAJMAI
#colors
red: A, 0, A, A, C, B, B
#initial
+++++++++
+ +   A0+
+ +   A +
+ +   A +
+ + + C +
+   + B +
+   + B +
+++++++++
#goal
+++++++++
+A+     +
+C+     +
+B+     +
+A+ +   +
+BA +   +
+   +   +
+++++++++
#end
