#domain
hospital
#levelname
SALobot
#colors
red: F, G, A, D, E, B, 0, C
#initial
+++++++++++++
+ +++F+++ +++
+ +++ +++G+++
+ +++ +++ +++
+ A   DE    +
+           +
+B    0    C+
+++++++++++++
#goal
+++++++++++++
+C+++ +++F+++
+B+++E+++ +++
+A+++D+++ +++
+           +
+           +
+           +
+++++++++++++
#end
