#domain
hospital
#levelname
SAZEROagent
#colors
red: G, B, C, D, E, H, I, J, A, 0
#initial
+++++++++++++++++++++
+ +                 +
+ +G B C D E HIJ    +
+ +                 +
+ +                 +
+ +                 +
+ +                 +
+ +                 +
+ +                 +
+ +                 +
+ +                 +
+ +                 +
+ +                 +
+ +                 +
+                   +
+                   +
+                   +
+       +++++++++++++
+     A0+
+++++++++
#goal
+++++++++++++++++++++
+A+                 +
+B+                 +
+C+                 +
+D+                 +
+E+                 +
+G+                 +
+H+                 +
+I+                 +
+J+                 +
+ +                 +
+ +                 +
+ +                 +
+ +                 +
+                   +
+                   +
+                   +
+       +++++++++++++
+       +
+++++++++
#end
