#domain
hospital
#levelname
MAAIoliMAsh
#colors
red: 0,A
blue: 1,B
cyan: 2,C
purple:  3,D
pink: 4,E
#initial
++++++++++++++++
+++++DB+B+++2+++
++++++A+C+++B+++
++ ++          +
+    A CCC    0+
++ E+          +
+++4++C+++++A+++
++++++3+++++1+++
++++++++++++++++
#goal
++++++++++++++++
+++++  + +++ +++
++++++ + +++ +++
++C++          +
+CDEB          +
++C +          +
+++ ++ +++++ +++
++++++ +++++ +++
++++++++++++++++
#end
