#domain
hospital
#levelname
SAIamGreedy
#colors
red: 0, B, B, B, B, B, B, B, B, B, B, B, B, C, A, A, D, A, D, C, B, A, C, C, E, A, A, A, A, A, A
#initial
++++++++++++++++++++++++++++++++++++++++++++++++++++++++++++
+ 0        BBB BBB BBB BBB     +C        +                 +
+                              +++++++ + +                 +
+                                    + + +       A         +
+                              +++++ + + +                 +
+                          A         + + +                 +
+ +++++++++++ +++++++ ++++++++++++++++ +             D     +
+ +         + +     + +    +A          +++++++++++++++++++++
+ +         + +     + +    +                             D +
+ +           +            +                             C +
+ +           +            +                             B +
+ +           +            +                             A +
+ +C          +C           +                               +
+ ++++++++++++++++++++++++++++++                    E      +
+                         AAAAA+                           +
+                              +                           +
+                              +                           +
+                                  A                       +
+                              +                           +
+                              +                           +
+                              +                           +
+                              +                           +
++++++++++++++++++++++++++++++++++++++++++++++++++++++++++++
#goal
++++++++++++++++++++++++++++++++++++++++++++++++++++++++++++
+                             A+      C  +                 +
+                              +++++++ + +                 +
+                                  B + + +        A        +
+                              +++++ + + +                 +
+                                    + + +                 +
+B+++++++++++B+++++++ ++++++++++++++++ +              D    +
+B+         +B+     +B+    +           +++++++++++++++++++++
+B+         +B+     + +    +                              A+
+ +           +            +                              B+
+ +           +            +                              C+
+ +           +            +                              D+
+ +          C+           C+                               +
+ ++++++++++++++++++++++++++++++                     E     +
+                              +                           +
+                              +                           +
+                              +                           +
+                                   A                      +
+                              +                           +
+                              +                           +
+                              +                           +
+                         AAAAA+                       A   +
++++++++++++++++++++++++++++++++++++++++++++++++++++++++++++
#end
