#domain
hospital
#levelname
MAGroupName
#colors
blue: 0, A, I, Q, Y
cyan: 1, B, J, R
purple: 2, C, K, S
orange: 3, D, L, T
pink: 4, 8, E, M, U
grey: 5, F, N, V
red: 6, G, O, W
green: 7, H, P, X
#initial
++++++++++++++++++++++++++++++++++++++++++++++++
++0++1++2++3+++++++++++++++++++++++++4++5++6++7+
++ ++A++B++D+++++++++++++++++++++++++A++E++G++G+
++ ++ ++A++C+++++++++++++++++++++++++B++B++F++B+
++ ++ ++ ++A+++++++++++++++++++++++++D++D++A++E+
+                     +                        +
+                     +                        +
+                     +                        +
+                     +                        +
++++++B+++++++++++++++++++++++++++++D+++++++++++
++++++BB+++++++++++++++++++++++++++DD+++++++++++
+++++++B+++++++++++++++++++++++++++D++++++++++++
+                                              +
+                                              +
++++++++++++++++++++++H+++++++++++++++++++++++++
+                                              +
+                                              +
+                     IJKLMNOP         IJKLMNOP+
+   IJKLMNOP    IJKLMNOP     IJKLMNOPIJKLMNOP  +
+IJKLMNOPIJKLMNOP      IJKLMNOP     IJKLMNOP   +
+                  IJKLMNOP   IJKLMNOP         +
+                                              +
+                                              +
+                                              +
+++ +++ +++ +++ +++ +++ +++ ++++++++++++++++++++
+++ +++ +++ +++ +++ +++ +++ ++++++++++++++++++++
+++ +++ +++ +++ +++ +++ +++ ++++++++++++++++++++
+++ +++ +++ +++ +++ +++ +++ ++++++++++++++++++++
+++ +++ +++ +++ +++ +++ +++ ++++++++++++++++++++
+++ +++ +++ +++ +++ +++ +++ ++++++++++++++++++++
+++ +++ +++ +++ +++ +++ +++ ++++++++++++++++++++
+++ +++ +++ +++ +++ +++ +++ ++++++++++++++++++++
++++++++++++++++++++++++++++++++++++++++++++++++
++++++++++++++++++++++++++++++++++++++++++++++++
++++++++++++++++++++++++++++++++++++++++++++++++
++++++++++++++++++++++++++++++++++++++++++++++++
++++++++++++++++++++++++++++++++++++++++++++++++
++++++++++++++++++++++++++++++++++++++++++++++++
++++++++++++++++++++++++++++++++++++++++++++++++
++++++++++++++++++++++++++++++++++++++++++++++++
#goal
++++++++++++++++++++++++++++++++++++++++++++++++
++ ++ ++ ++ +++++++++++++++++++++++++ ++ ++ ++ +
++ ++ ++ ++ +++++++++++++++++++++++++ ++ ++ ++ +
++ ++ ++ ++ +++++++++++++++++++++++++ ++ ++ ++ +
++ ++ ++ ++ +++++++++++++++++++++++++ ++ ++ ++ +
+                     +                        +
+                     +                        +
+                     +                        +
+                     +                        +
++++++ +++++++++++++++++++++++++++++ +++++++++++
++++++  +++++++++++++++++++++++++++  +++++++++++
+++++++ +++++++++++++++++++++++++++ ++++++++++++
+                                              +
+                                              +
++++++++++++++++++++++ +++++++++++++++++++++++++
+                                              +
+                                              +
+                                              +
+                                              +
+                                              +
+                                              +
+                                              +
+                                              +
+                                              +
+++I+++I+++I+++I+++I+++I+++I++++++++++++++++++++
+++J+++J+++J+++J+++J+++J+++J++++++++++++++++++++
+++K+++K+++K+++K+++K+++K+++K++++++++++++++++++++
+++L+++L+++L+++L+++L+++L+++L++++++++++++++++++++
+++M+++M+++M+++M+++M+++M+++M++++++++++++++++++++
+++N+++N+++N+++N+++N+++N+++N++++++++++++++++++++
+++O+++O+++O+++O+++O+++O+++O++++++++++++++++++++
+++P+++P+++P+++P+++P+++P+++P++++++++++++++++++++
++++++++++++++++++++++++++++++++++++++++++++++++
++++++++++++++++++++++++++++++++++++++++++++++++
++++++++++++++++++++++++++++++++++++++++++++++++
++++++++++++++++++++++++++++++++++++++++++++++++
++++++++++++++++++++++++++++++++++++++++++++++++
++++++++++++++++++++++++++++++++++++++++++++++++
++++++++++++++++++++++++++++++++++++++++++++++++
++++++++++++++++++++++++++++++++++++++++++++++++
#end
