#domain
hospital
#levelname
MAAIoliMAsh
#colors
red: 0, A, B
blue: 1, C
cyan: 2
grey: 3, D
pink: 4, E
#initial
++++++++++++++++++
+        +       +
+                +
+0       +       +
+        +++++++++
+        +++++++++
+             AB1+
+     C  +++++++++
++++++++++++++++++
#goal
++++++++++++++++++
+        +       +
+        B       +
+0       +       +
+        +++++++++
+        +++++++++
+             A  +
+        +++++++++
++++++++++++++++++
#end
